0 	0  	0	0	0	0	0 	0 	0 	0 	0 	0	0	0	0	0	0	0	0	0	0	0	0	0	0
0 	0  	0 	0	0 	0	0 	0 	11 	13 	12	3	4	3	12	13	11	0	0	0	0	0	0	0	0
0 	0  	0 	0	0 	0	0 	2 	11 	13 	12	3	26	3	12	13	11	2	0	0	0	0	0	0	0
0 	0  	0 	0	0 	0	1 	21 	11 	13 	12	3	4	3	12	13	11	2	1	0	0	0	0	0	0
0 	0  	0 	0	0 	2	1 	2 	11 	13 	12	22	4	22	12	13	11	2	1	2	0	0	0	0	0
0 	0  	0 	0	1 	2	1 	2 	11 	13 	12	3	4	3	12	13	11	2	25	2	1	0	0	0	0
0 	0  	0 	2	1 	2	1 	2 	11 	13 	12	3	4	3	12	13	11	2	1	2	1	24	0	0	0
0 	0  	1 	24	1 	2	25 	2 	14 	14 	14	14	14	14	14	14	14	21	1	2	1	2	1	0	0
0 	2  	1 	2	1 	2	1 	2 	14 	13 	12	3	4	3	12	13	14	2	1	2	1	2	25	2	0
25 	21  1 	2	1 	2	1 	2 	14 	13 	12	3	26	3	12	13	14	2	1	21	1	2	1	2	1
0 	2  	1 	2	25 	2	1 	2 	14 	13 	12	3	4	3	12	13	14	2	1	2	1	2	1	24	0
0 	0  	1 	2	1 	2	1 	21 	14 	13 	12	22	4	22	12	13	14	24	1	2	1	2	1	0	0
0 	0  	0 	24	1 	2	1 	2 	14 	14 	14	14	14	14	14	14	14	2	1	2	1	2	0	0	0
0 	0  	0 	0	1 	2	1 	2 	11 	13 	12	3	4	3	12	13	11	2	1	2	1	0	0	0	0
0 	0  	0 	0	0 	2	1 	2 	11 	13 	12	3	4	3	12	13	11	2	1	2	0	0	0	0	0
0 	0  	0 	0	0 	0	1 	2 	11 	13 	12	3	26	3	12	13	11	2	1	0	0	0	0	0	0
0 	0  	0 	0	0 	0	0 	2 	11 	13 	12	3	4	3	12	13	11	2	0	0	0	0	0	0	0
0 	0  	0 	0	0 	0	0 	0 	11 	13 	12	3	4	3	12	13	11	0	0	0	0	0	0	0	0
0 	0  	0	0	0	0	0 	0 	0 	0 	0 	0	0	0	0	0	0	0	0	0	0	0	0	0	0
