1 1 1 2 1 1 1 1 1 2 2 2 2 2 1 1 1 1 1 1 1 2 1 1 1
1 1 1 24 1 2 1 2 1 2 1 2 1 2 1 2 1 2 1 2 1 2 1 1 1
1 1 1 2 1 2 1 2 1 2 1 2 1 2 1 2 1 2 1 2 1 2 1 1 1
1 1 1 2 1 2 1 2 1 2 1 2 1 2 1 2 1 2 1 2 1 2 1 1 1
1 1 1 2 1 2 1 2 1 2 1 2 1 2 1 2 1 2 1 2 1 2 1 1 1
1 1 1 2 1 2 1 2 1 24 1 2 1 2 1 2 1 2 1 24 1 2 1 1 1
1 1 1 2 1 2 1 2 1 2 1 2 1 2 1 2 1 2 1 2 1 2 1 1 1
1 1 1 2 1 2 1 21 1 2 1 2 1 2 1 2 1 2 1 2 1 2 1 1 1
2 3 1 2 1 2 1 2 1 2 1 2 1 2 1 2 1 2 1 2 1 2 1 2 3
22 2 1 2 1 2 1 2 1 2 1 2 1 2 1 2 1 2 1 2 1 2 1 22 2
2 3 1 24 1 2 1 2 1 2 1 2 1 2 1 2 1 2 1 2 1 2 1 2 3
1 1 1 2 1 2 1 2 1 2 1 2 1 2 1 2 1 2 1 2 1 2 1 1 1
1 1 1 21 1 2 1 2 1 2 1 2 1 2 1 2 1 2 1 2 1 2 1 1 1
1 1 1 2 1 2 1 2 1 2 1 2 1 2 1 2 1 2 1 2 1 2 1 1 1
1 1 1 2 1 24 1 2 1 2 1 2 1 2 1 2 1 2 1 2 1 2 1 1 1
1 1 1 2 1 2 1 2 1 2 1 2 1 2 1 2 1 2 1 2 1 21 1 1 1
1 1 1 2 1 2 1 2 1 2 1 2 1 2 1 2 1 2 1 2 1 2 1 1 1
1 1 1 2 1 2 1 2 1 2 1 2 1 2 1 2 1 2 1 2 1 2 1 1 1
25 1 1 21 1 1 1 1 1 24 2 2 2 2 1 1 25 1 1 1 1 21 1 1 1
