0 0 0 0 0 0 0 0 1 2 1 2 1 2 1 2 1 0 0 0 0 0 0 0 0
0 0 0 0 0 0 0 2 1 2 1 2 1 2 1 24 1 2 0 0 0 0 0 0 0
0 0 0 0 0 0 1 2 25 2 1 2 1 2 1 2 1 2 1 0 0 0 0 0 0
0 0 0 0 0 2 1 2 1 2 1 2 1 2 1 2 1 2 25 2 0 0 0 0 0
0 0 0 0 1 2 1 2 1 2 1 2 1 21 1 2 1 2 1 2 1 0 0 0 0
0 0 0 2 1 24 1 2 1 2 1 2 1 2 25 2 1 2 1 2 1 21 0 0 0
0 0 1 2 1 2 1 2 1 2 25 2 1 2 1 2 1 2 1 2 1 2 1 0 0
0 1 1 2 1 2 1 2 1 2 1 2 1 2 1 2 1 2 1 2 1 2 1 1 0
0 4 23 4 4 4 4 4 4 4 4 4 4 4 4 4 4 4 4 4 4 4 23 4 0
3 3 3 3 3 3 22 3 3 3 3 3 3 3 3 3 3 3 3 3 3 3 3 3 22
0 4 23 4 4 4 4 4 4 4 4 4 4 4 4 4 4 4 4 4 4 4 23 4 0
0 1 1 21 1 2 1 2 1 2 1 2 1 2 1 21 1 2 1 2 25 2 1 1 0
0 0 1 2 1 2 1 2 1 24 1 2 1 2 25 2 1 2 1 2 1 2 1 0 0
0 0 0 2 1 2 1 2 25 2 1 2 1 2 1 2 1 2 1 2 1 2 0 0 0
0 0 0 0 1 2 1 2 1 2 1 2 1 2 1 2 1 2 1 2 1 0 0 0 0
0 0 0 0 0 24 1 2 1 2 1 2 1 2 1 2 1 24 1 2 0 0 0 0 0
0 0 0 0 0 0 1 2 25 2 1 2 1 2 1 2 1 2 1 0 0 0 0 0 0
0 0 0 0 0 0 0 2 1 2 1 2 1 2 1 2 1 2 0 0 0 0 0 0 0
0 0 0 0 0 0 0 0 1 2 1 2 1 2 1 24 1 0 0 0 0 0 0 0 0
